NO ./images/NORTH.png
SO ./images/SOUTH.png
WE ./images/WEST.png
EA ./images/EAST.png

F 225,200,0
C 225,30,0

11111111
10010011
10010001
11000111
10010011
10110101
1N110011
11111111