NO ./images/NORTH_100.png
SO ./images/SOUTH_100.png
WE ./images/WEST_100.png
EA ./images/EAST_100.png

C 60,179,110
F 60,179,110


1111111111111111111111111111111111111111111111111111
100000000011000000000000111000000000110000000000011
101100000111000000000000111011000001110000000000011
1001000000000000100000001110010000000000001000000011
1111111110110000111000011111111111011000011100001101
1000000000110000011101111110000000001100000111011111
11110111111101011100000010000000000011010111000000111111
    111101111000011011010100000000111100001101110101001
    11110111100001101 1010100000000111100001101110101001
    11110111100001101 11010100000000111100001101110101001
    11110111100001101 1010100000000111100001101110101001
    11110111100001101 1010100000000111100001101110101001
    11110111100001101 1010100000000111100001101110101001
    1111011110001 10110101001111011110000110111010111001
11110111100001101 10101000000001111000011011101010011111
11000001 10101011 1101001111000001110101011111010011
11111111 11111111 1111111111111111111111111111111111
1111111111111111111111111111111111111111111111111111
100000000011000000000000111000000000110000000000011
101100000111000000000000111011000001110000000000011
1001000000000000100000001110010000000000001000000011
1111111110110000111000011111111111011000011100001101
1000000000110000011101111110000000001100000111011111
11110111111101011100000010000000000011010111000000111111
    111101111000011011010100000000111100001101110101001
    11110111100001101 1010100000000111100001101110101001
    11110111100001101 11010100000000111100001101110101001
    11110111100001101 1010100000000111100001101110101001
    11110111100001101 1010100000000111100001101110101001
    11110111100001101 1010100000000111100001101110101001
    1111011110001 10110101001111011110000110111010111001
11110111100001101 10101000000001111000011011101010011111
11000001 10101011 1101001111000001110101011111010011
11111111 11111111 1111111111111111111111111111111111