NO ./images/green_bricks.png
SO ./images/grey_bricks.png
WE ./images/grey_bricks.png
EA ./images/grey_bricks.png

C 255,182,193
F 231,84,128

11111111
10000001
11101011
10001N11
11111111