NO ./images/NO.png
SO ./images/SO.png
WE ./images/WE.png
EA ./images/EA.png

C 255,182,193
F 231,84,128

111111111111111111111
1000001110000000000001
1000001110111111111111
111111011100000000001
11111011101010000001
10101011100000010001
100000001100000010001
100000001101010010001
101011111011110N0111
1110101 101111010001
1111111 111111111111